%%%%%%%%%%%%
%      G   %
%..........%
%..........%
%%%%%% %%%%%
%          %
%         P%
%%%%%%%%%%%%